1111100000000
1C000000000C1
1001101111001
1P001C0000001
0111101011011
000000001100E
