1111111111111
1C010000000C1
1000011111001
1P001C0000001
1111101011111
1E00000011111
